00000000000000000000000000000000000000000000000000000
00000000000022222000000000000000000000000022222222000
00000000000000000000000000000000000000000000000000000
00000222200000000000000000000000000222200000000000000
00000000000000000000000000000000000000000000000000000
00000000000000000000000000000000000000000000000000000
22000000000000000220000002200000000000000000000000000
1122222222222222211000022112000000022222222222222222200022222222
11111111111111111110000111110000000111111111111111111
11111111111111111110000011000000000111111111111111111
11111111111111111110000010000000000111111111111111111
11111111111111111110000010000000000111111111111111111
11111111111111111110000000000000000111111111111111111